0xABCDEFE
0x1000600
0xF000003
0x1100C00
0xF000003
0x2021000
0xF000003
0xE000103
0xE000203
0x3120000
0xE000103
0xE000203
0x8F000C0
0xF00E48C
0xF00E45C
0xF00E4CC
0xF00E4CC
0xF00E4FC
0xF00E20C
0xF00E57C
0xF00E4FC
0xF00E52C
0xF00E4CC
0xF00E44C
0xF00E21C
0xF00E0AC
0xF00E00F
0x8F000F0
0xDEAD